R 1000 700

NO ./colorstone.xpm
SO ./colorstone.xpm
WE ./bluestone.xpm
EA ./colorstone.xpm

S  ./barrel.xpm
F 0,255,0
C 0,0,225

        1111111111111111111111111
        1000000000110000000002001
        1011000001110000000002021
        1001000000000000N00002001
111111111011000001110000000000001
100000000011000001110111111111111
11110111111111011100000010001
11110111111111011101010010001
11000000110101011100000010001
10000000000000001100000010001
10000000000000000001010010001
1100000111010101111101111000111
11110111 1110101 101111010001
11111111 1111111 111111111111
